  1111111111111111111111111
1000000000000000000000001
1000000000000000000000001
1000000000000000000000001
10000000222220000030003001
10000000200002000000000001
10000000200002000030003001
10000000200002000000000001
10000000222220000030003001
1000000000000000000000001
1000000000000000000000001
1000000000000000000000001
1000000000000000000000001
1000000000000000000000001
1000000000000000000000001
1000000000000000000000001
10044444000000000000000001
10404000000000000000000001
10400005000000000000000001
10404000000000000000000001
10044444000000000000000001
1000000000000000000000001
10044444000000000000000001
1111111111111111111111111