
WE ./sprites/three.xpm

C 225,30,1

EA ./sprites/four.xpm

SO ./sprites/two.xpm

NO ./sprites/one.xpm

F 122,143,11








11111
10001
10001
10101
10001
10N01
11111


