
WE ./sprites/three.xpm

C 225,30,1

EA ./sprites/four.xpm

SO ./sprites/two.xpm

NO ./sprites/one.xpm

F 66,66,66








11111
10001
10001
10001
10001
100N1
11111


