 1111111111111111111111111
1000000000000000000000001
1000000000000000000000001
 1000000000000000000000001
1000000011110000010001001
10000000100001000000000001
10000000100001000010001001
10000000100001000000000001
10000000111110000010001001
  1000000000000000000000001
1000000000000000000000001
1000000000000000000000001
1000000000000000000000001
1000000000000000000000001
10000000000000N0000000001
1000000000000000000000001
1001111000000000000000001
10101000000000000000000001
10100001000000000000000001
10101000000000000000000001
1001111000000000000000001
1000000000000000000000001
 1001111000000000000000001
1111111111111111111111111